25 20
#############            
#...........#    ########
#...s.......######......#
#.......................#
#...........######...S..#
#...........#    #......#
#...........#    #......#
#...........#    #......#
#####..######    ###..###
    #..#           #..#  
    #..#           #..#  
    #..#         ###..###
  ###..####      #......#
  #.......#      #..k...#
  #.......#      #......#
  #.......#      #......#
  #.......#      #......#
  #.......#      #......#
  #.......#      #.....u#
  #########      ########